ATAGTCTCAATAGTTAAAAAATTGAATTTCA	gambiae_sine2
ACAATGCATAAAATTCTTAGTGGAGCGAAAT	arabiensis_sine2
TTGAGACTATTAGACATCCTTATCATTCCCA	arabiensis_sine2
ACATACTAAAATAATGAATTAAATGCAGTTC	melas_sine2
CCAAAATACATGAAATTCAATTTTTCAACTA	melas_sine2
ACTATTAGACATCCTAAAATAATGAATTAAA	gambiae_sine2
AAATGGGCCGGTCTCGTAGTACAGTCGTCTA	coluzzi_sine2
CAACCGATGTCGGTCAAGGCCTGTCTGTAAC	coluzzi_sine2
TGGGTTCAATCCCCAAATAGACCGCGCCGCC	coluzzi_sine2
AGTGGATACTCTTGTGAGAGCAAGAGTGTAC	melas_igs
GCCCCTTCCTCGATGGCGTTATTCACCATCT	melas_igs
TTACACGAGTGGACAAGAGTTGGCTCCTTCC	melas_igs
AGGGGATACTTTTGTGAGAGCAAGAGTGTAC	gambiae_complex_igs
GCCCCTTCCTCGATGGCGCAACGAACCATCT	gambiae_complex_igs
TTACACTAGTGGACAAGAGCTGGCTACTTCC	gambiae_complex_igs
AGGGGGATACTCTTGTGAGAGCATGAGTGTA	arabiensis_igs
GCCCCTTCCTCGTTGGCGTAACTAACCATCT	arabiensis_igs
TTATACTAGTGGACAAGAGTTGGCTACTTCC	arabiensis_igs
TCAGTCTTTTTAAGGGAAAACAGGTCACGTC	arabiensis_gste2
AGCTAAAGTCGGCAATCGTCATGCTCGGTCC	arabiensis_gste2
AAACTTGCCCAGATCGGTGCCTCCGCCACCG	arabiensis_gste2
ACAGGTCACGTCACTTACGAAAGTGAATCTC	coluzzii_gste2
GATGAGATTCATTTTCGTAAGTGACGTGACC	gambiae_gste2
TCCAGCATAACGTCACGCATTTTCCAACCCC	melas_gste2
CTTCGACTGCTCCAACAGCACAACACCCATA	melas_gste2